Consumables by Zzybzfrx begins here.

Use authorial modesty.

Include Items by Zzybzfrx.
Include Player by Zzybzfrx.

Volume - Food

A food is a kind of thing. A food is edible.

A food has a number called energy. Energy is usually 1.
A food has a number called base_cost. Base_cost is usually 0.

Understand the command "lick" as "taste".
Understand the command "sniff" as something new.
Understand the command "sniff" as "smell".

Understand the command "poke" and "prod" and "palpitate" as "touch".

Chapter - Abbasid Ribs

An abbasid ribs is a kind of food.
The description is "Succulent Abbasid ribs, made using a time-honored Abbasidian recipe."

Chapter - Applejack

An applejack is a kind of food.
The description is "A bowl of apple-y, oat-y, cinnamon-y applejack. Yummy hot or cold."

Chapter - Apple

An apple is a kind of food.
The description is "A boldly red and brazenly juicy apple."
The energy of an apple is 10.

After eating an apple:
say "An apple a day keeps the plague doctor away.".

Instead of tasting an apple:
say "You licked an Apple. Mmmm, 'Appley'!".

Chapter - Awesome Stew

An awesome stew is a kind of food.
The description is "Chunky awesome stew, so thick you can eat it with a spork."

Chapter - Rasher of Bacon

A rasher of bacon is a kind of food.
The description is "A delicious, greasy, surprise Piggy treat from the Piggy's newly discovered Orthogonal Meat Generator (OMG)."
The plural of rasher of bacon is rashers of bacon.
The energy of rasher of bacon is 5.

Instead of smelling a rasher of bacon:
say "Something smells delicious.";
increase player's mood by 5.

Chapter - Banana

A banana is a kind of food.
The description is "A bright yellow, potassium-rich banana."

[caress: "Oops, you squashed it! You can't just go to town on a Banana like that; you have to be delicate."]
[with 1/3 chance; otherwise: mood +5 "Feels so smooth"]

Chapter - Banana No-Names

A banana no-names is a kind of food.
The description is "One banana fried to crispy, buttery perfection and drizzled with honey. Mmmm."

Chapter - Basic Omelet

A basic omelet is a kind of food.
The description is "A fluffy three-egg omelet."

Chapter - Berry Bowl

A berry bowl is a kind of food.
The description is "A very merry bowl of berries."

Chapter - Best Bean Dip

A best bean dip is a kind of food.
The description is "Bowl of beany, dippy bean dip."

Chapter - Big Salad

A big salad is a kind of food.
The description is "It's bigger than small. It's a big salad."

Chapter - Birch Candy

A birch candy is a kind of food.
The description is "Candy made of boiled birch syrup so concentrated and so sweet that one too many and you may see god. Or at least the tooth fairy. And they'll be crying."
The plural of birch candy is birch candies.

[sugar rush: "OMGiant! Harder Faster Better Stronger Sugar Sugar Sugar Sugar!"; lasts 2 minutes; +28 mood; then sugar crash]
[Sugar crash: mood -40, energy -20]

Chapter - Birch Syrup

A birch syrup is a kind of food.
The description is "A bottle of sticky birch syrup."

Chapter - Bubble and Squeak

A bubbling squeak is a kind of food.
The description is "Meaty, carroty, potato-y mush, fried to perfection."

Chapter - Bunch of Grapes

A bunch of grapes is a kind of food.
The description is "A heaping handful of red grapes."
The plural of bunch of grapes is bunches of grapes.

Chapter - Bun

A bun is a kind of food.
The description is "A nice round bun."

Chapter - Butterfly Butter

A butter is a kind of food. The printed name is "butterfly butter". Understand "butterfly butter" as butter.
The description is "Butterfly butter might seem like an odd thing, but it is used in many delicious cooking recipes."

[compress: "You squeeze the butterfly butter with all your might and cheese appears!", -5 energy, turns into cheese]

Chapter - Raw Bio-Organic Carob-ish Treat

A raw bio-organic carob-ish treat is a kind of food.
The description is "A chewy, crunchy, apparently ethically-sourced, gritty 'candy-alternative' with a whiff of winter. Leaves a unique chocolatey aftertang you can't quite put your finger on."

[sugar rush, followed by sugar crash]

Chapter - Cheese Plate

A cheese plate is a kind of food.
The description is "An assortment of fine cheeses."

Chapter - Cheese

A basic cheese is a kind of food. The printed name is "cheese".
The description is "A nice wedge of holey cheese."
The energy of a basic cheese is 15.

Aging is an action applying to one thing.
Understand "age" as aging.
Carry out aging: say "You can't age that!"

Instead of aging a basic cheese (called C):
say "You put the cheese in your pocket for a while and it ages nicely. It left a bit of a smell in your pocket though.";
decrease player's energy by 5;
decrease player's mood by 5;
[remove the C from play;]
[now the player carries a random stinky cheese 1 that is off-stage.]

Instead of smelling a basic cheese:
increase player's mood by 10;
decrease player's energy by 5;
say "It smells fairly nice. It might smell nicer if you aged it." 

Book - Stinky Cheese

A stinky cheese 1 is a kind of food. The printed name is "stinky cheese".
The description is "A lump of cheese that's been left to stand around for a while. It's what the French call 'ripe'. You could age it longer, but glory only knows what the French would call it then."

Instead of smelling a stinky cheese 1:
say "Yep. That's a stinky cheese all right."

Instead of aging a stinky cheese 1 (called C):
say "If you concentrate really hard on it, the cheese does indeed age.";
decrease player's energy by 10;
[remove C from play;]
[now the player carries a random stinky cheese 2 that is off-stage.]

Instead of tasting a stinky cheese 1:
say "Awesome. Now you have stink-tongue.";
decrease player's mood by 20.

After eating a stinky cheese 1: 
say "Stinky Cheese? Not bad. Would have been better with some stinky crackers, though.";
increase the player's energy by 21.

Book - Very Stinky Cheese

A stinky cheese 2 is a kind of food. The printed name is "very stinky cheese".
The description is "Smelling like a manatee bathed in celery juice and old surgical stockings, goodness knows what would happen if you aged this connoisseurial cheese any longer. You could give it a go, though..."

Instead of aging a stinky cheese 2 (called C):
say "Wow, is that ever draining. But the cheese [italic type]is[roman type] visibly aged.";
decrease player's mood by 20;
decrease player's energy by 20;
[remove C from play;]
[now the player carries a random stinky cheese 3 that is off-stage.]

Instead of smelling a stinky cheese 2:
say "Phew. That [italic type]is[roman type] very stinky."

After eating a stinky cheese 2:
say "After all the hubbub about the very stinky cheese, its actual stinkiness is a little anti-climactic.";
increase the player's energy by 27.

Instead of touching a stinky cheese 2:
say "After sticking an investigatory pinkie in the soft, gooey cheese, you encounter a hard object. You pull it out. It's a small shiny object with no intrinsic value!";
decrease player's energy by 10;
[now the player carries a random small shiny object that is off-stage.]

Book - Very, Very Stinky Cheese

A stinky cheese 3 is a kind of food. The printed name is "very, very stinky cheese".
The description is "This is the very, very stinkiest cheese you've ever seen, or it would be if you could see through the thick veil of tears it's inducing. You can't make this any stinkier. It wouldn't be fair to everyone else."

Instead of smelling a stinky cheese 3:
say "At first sniff, this is one of the worst olfactory experiences of your life. On your second sniff, you experience an epiphany, which you forget almost immediately. The cheese was destroyed by your intense sniffing.";
increase player's mood by 50;
decrease player's energy by 50;
remove the stinky cheese 3 from play.

Instead of aging a stinky cheese 3:
say "You couldn't possibly age this cheese any more."

After eating stinky cheese 3:
say "In addition to dazzling your friends with your intestinal fortitude, you also reap the very, very stinky cheese's bounteous nutritional benefits.";
increase player's energy by 33.

Instead of touching the stinky cheese 3:
say "That was not a good idea. It's going to take a while for that finger-stink to wear off.";
decrease player's mood by 50.

Book - Fancy Cheese

A fancy cheese is a kind of food.

Chapter - Cheezy Sammich

A cheezy sammich is a kind of food.
The description is "An easy, pleasey, cheezy sammich."
The plural of cheezy sammich is cheezy sammiches.

Chapter - Cheezy Sauce

A cheezy sauce is a kind of food.
The description is "A crock full of pleasingly, teasingly cheezy sauce."

Chapter - Chilly-Busting Chili

A chilly-busting chili is a kind of food.
The description is "A tureen of fiery chilly-busting chili."

Chapter - Choice Crudites

A choice crudites is a kind of food.
The description is "A platter of the very finest crudites."

Chapter - Cloudberry Jam

A cloudberry jam is a kind of food.
The description is "A jar of tart cloudberry jam."

Chapter - Cloudberry

A tart cloudberry is a kind of food. The printed name is "cloudberry".
The description is "A pleasingly tart cloudberry."
The plural of cloudberry is cloudberries.

Chapter - Cold Taco

A cold taco is a kind of food.
The description is "A refreshing cold taco."

Chapter - Common Crudites

A common crudites is a kind of food.
The description is "Everyday crudites served in an easy-to-carry cup."

Chapter - Corn-off-the-Cob

A corn-off-the-cob is a kind of food.
The description is "All the goodness of corn-on-the-cob, without the cob."

Chapter - Hi-Sucrose Corn Syrup Square

A hi-sucrose corn syrup square is a kind of food.
The description is "Densely-packed brick of pure brain-melting sweetness, proving that sometimes the sum of many food items is either something that is only fit for use as building material in a fairy unicorn happy-palace, or a candy."

[sugar rush, followed by sugar crash]

Chapter - Corny Fritter

A corny fritter is a kind of food.
The description is "Some delicately frittered corn."

Chapter - Creamy Catsup

A creamy catsup is a kind of food.
The description is "One gallon of the creamiest catsup in all the land."

Chapter - Death to Veg

A death to veg is a kind of food.
The description is "For those who wish a violent end to all harmless vegetables, and desire to feast upon their flesh."

Chapter - Deluxe Sammich

A deluxe sammich is a kind of food.
The description is "A deeply satisfying deluxe sammich."
The plural of deluxe sammich is deluxe sammiches.

Chapter - Desssert Rub

A desssert rub is a kind of food.
The description is "Gritty, sandlike, and strangely sweet, this is both sandy like the desert, and sweet like dessert, and, as such, has the s's of both."
The energy of desssert rub is 0. [0.1.]

Chapter - Divine Crepe

A divine crepe is a kind of food.
The description is "Life-changingly scrumptious crepes."

Chapter - Eggy Scramble

An eggy scramble is a kind of food.
The description is "A messily scrumptious pile of eggs."

Chapter - Exotic Fruit Salad

An exotic fruit salad is a kind of food.
The description is "An enticing array of exotic fruits."

Chapter - Expensive Grilled Cheese

An expensive grilled cheese is a kind of food.
The description is "Expensive cheese expensively grilled on expensive bread."

Chapter - Flour

A flour is a kind of food.
The description is "Some ordinary white, powdery flour."

Chapter - Flummery

A flummery is a kind of food.
The description is "Few things in this life are as tasty as a masterfully prepared flummery. 'Just like Mom used to make!' you might say. If you had a mom, that is."

Chapter - Fortifying Gruel

A fortifying gruel is a kind of food.
The description is "One bowl of lumpy fortifying gruel."

Chapter - Fried Egg

A fried egg is a kind of food.
The description is "One sunny-side-up egg."

Chapter - Fried Noodles

A fried noodles is a kind of food.
The description is "A small slippery hill of fried noodles."

Chapter - Fried Rice

A fried rice is a kind of food.
The description is "A bowl of fried rice with lots of nummy bits."

Chapter - Frog-in-a-Hole

A frog-in-a-hole is a kind of food.
The description is "A perfect egg perfectly fried in a perfect hole in a slice of bread."
The plural of frog-in-a-hole is frogs-in-a-hole.

Chapter - Fruit Salad

A nice fruit salad is a kind of food. The printed name is "fruit salad".
The description is "A nice fruit salad."

Chapter - Gamma's Pancake

A gammas pancake is a kind of food. The printed name is "Gamma's pancake".
The description is "One mouthwatering pancake, just like Gamma used to make."

Chapter - Glitchepoix

A glitchepoix is a kind of food.
The description is "This combination of vegetables was known as the holy quadrinity of the Glitchean cuisine."
The plural of glitchepoix is glitchepoixes.

Chapter - Greasy Frybread

A greasy frybread is a kind of food.
The description is "A fresh chunk of butter-running-down-your-arms greasy frybread."

Chapter - Green Egg

A green egg is a kind of food.
The description is "One order of fried green eggs, hold the ham."

Chapter - Green

A green thing is a kind of food. The printed name is "green".
The description is "So fundamental, so intrinsic to the basic laws of culinary science and a healthy spleen that there was only ever one word needed to describe it: Green. So, so green."

Chapter - Grilled Cheese

A comforting grilled cheese is a kind of food. The printed name is "grilled cheese".
The description is "A comforting grilled cheese."

Chapter - Hash

A hash is a kind of food.
The description is "A serving of oddly satisfying hash."
The plural of hash is hashes.

Chapter - Hearty Groddle Sammich

A hearty groddle sammich is a kind of food.
The description is "A meaty Groddle sammich with extra hot in fizzy sauce for extra hot in fizzy energy."
The plural of hearty groddle sammich is hearty groddle sammiches.

[Hearty Feeling: "You feel like you can weather anything. Even bad weather." (immune from ill effects of cold for 1 minute)]

Chapter - Hearty Omelet

A hearty omelet is a kind of food.
The description is "An unusually nourishing hearty omelet."

[Hearty Feeling]

Chapter - Heston Mash

A heston mash is a kind of food.
The description is "This is not just mashed potato, this is the fanciest, zaniest, most delicious mashed potato Ur has ever ingested. And yet, really, it's still just mashed potato."
The plural of heston mash is heston mashes.

Chapter - Honey

A honey is a kind of food.
The description is "A brimful jar of raw golden honey."

Chapter - Hot 'n' Fizzy Sauce

A hot in fizzy sauce is a kind of food.
The description is "One jar of potent hot in fizzy sauce. This combustible comestible is packed with energy and all kinds of flaming goodness."

Chapter - Hototot Rub

A hototot rub is a kind of food.
The description is "Oooh. Ow. Hot. Hotot. Hototot."
The energy of hototot rub is 0. [0.1]

Chapter - Hot Potatoes

A hot potatoes is a kind of food.
The description is "If someone gives you this 'tato, drop it like it's hot. Because it is."

Chapter - Hungry Nachos

A hungry nachos is a kind of food.
The description is "Are you hungry for nachos or are nachos hungry for you? It's nacho decision to make."

Chapter - Ix-Style Braised Meat

An ix-style braised meat is a kind of food.
The description is "A side of rich, meaty meat, braised a la Ix."

Chapter - Juicy Carpaccio

A juicy carpaccio is a kind of food.
The description is "A tempting platter of juicy carpaccio with all the trimmings."

Chapter - Kind BreakfURst Burrito (TM)

A kind breakfurst burrito is a kind of food. The printed name is "Kind BreakfURst Burrito (TM)".
The description is "Warning: Does not contain meat."
The plural of kind breakfurst burrito is kind breakfurst burritos.

Chapter - King of Condiments

A king of condiments is a kind of food.
The description is "Otherwise known as the blandest rub in all of Ur. Meh."
The plural of king of condiments is kings of condiments.
The energy of king of condiments is 0. [0.1]

Chapter - Lazy Salad

A lazy salad is a kind of food.
The description is "Sliced tomatoes and cheese. It doesn't get much lazier than a lazy salad."

Chapter - Legumes Abbassidienne

A legumes abbassidienne is a kind of food.
The description is "The most sophisticated, chic ways to prepare a bean: simply, classically, with a smile, a touch of flair, and a really big guillotine."

Chapter - Lemburger

A lemburger is a kind of food.
The description is "A single-decker Lemburger with all the fixins."

Chapter - Lemon

A lemon is a kind of food.
The description is "One half of a nice pair of lemons."

Chapter - Lotsa Lox

A lotsa lox is a kind of food.
The description is "Goodness! It's a lotta lox!"
The plural of lotsa lox is lotsa loxes.

Chapter - Luxury Tortellini

A luxury tortellini is a kind of food.
The description is "It's tortellini, stuffed with extravagance and drizzled with grandeur."

Chapter - Maburger Royale

A maburger royale is a kind of food.
The description is "It's not just seasoned beans in a bun smothered in stinky cheese - it's so much more than that. Oh no wait. It's just that."
The plural of maburger royale is maburgers royale.

Chapter - Mangosteen

A mangosteen is a kind of food.
The description is "A sweet and tangy mangosteen."

Chapter - Meat Gumbo

A meat gumbo is a kind of food.
The description is "A bowl of thick, meaty gumbo."

Chapter - Meat Tetrazzini

A meat tetrazzini is a kind of food.
The description is "Some creamy, meaty tetrazzini."

Chapter - Messy Fry-Up

A messy fry-up is a kind of food.
The description is "A sloppy, gloppy messy fry-up."

Chapter - Mexicali Eggs

A mexicali eggs is a kind of food.
The description is "A heaping serving of bean-infused eggs."

Chapter - Mild Sauce

A mild sauce is a kind of food.
The description is "Bland ho! It's some inoffensive mild sauce."

Chapter - Mushroom

A mushroom is a kind of food.
The description is "An unusually sporous mushroom."

Chapter - Naraka Flame Rub

A naraka flame rub is a kind of food.
The description is "A slightly spicy minute on the lips, a horrifically painful burning in the general area of the hips, some people say. But what do they know? Wussies."
The energy of naraka flame rub is 0. [0.1]

Chapter - Oats

An oats is a kind of food.
The description is "Regular non-wild oats."

Chapter - Oaty Cake

An oaty cake is a kind of food.
The description is "A slightly dry, somewhat crumbly oaty cake."

Chapter - Obvious Panini

An obvious panini is a kind of food.
The description is "A panini, obviously."

Chapter - Oily Dressing

An oily dressing is a kind of food.
The description is "A bottle of cheap, yet strangely satisfying, oily dressing."

Chapter - Olive Oil

An olive oil is a kind of food.
The description is "A bottle of top-notch olive oil, no virgins required."

Chapter - Onion Ring

An onion ring is a kind of food.
The description is "Battered and fried, these are onions prepared the way Pot intended. Rumored to be popular amongst the elves. Wait, what's an elf?"

Chapter - Onion Sauce

An onion sauce is a kind of food.
The description is "A jar of eye-wateringly zesty onion sauce."

Chapter - Orange

An orange is a kind of food.
The description is "A very orange orange."

Chapter - Pad Tii

A pad tii is a kind of food.
The description is "Tii has not heard of this dish yet. Chances are it would not approve. Do not tell Tii. Please."

Chapter - Pineapple Upside-Down Pizza

A pineapple upside-down pizza is a kind of food.
The description is "A plate of exotically topsy-turvy pizza."

Chapter - Roasted Pepitas

A roasted pepitas is a kind of food.
The description is "Crunchy, nutty, seeds pulled from a pumpkin ready roasted (it must be that hot knife you used). May cause a roasted pumpkin to grow in your stomach. No, not really. Will cause you to feel smug about your healthy snacking choices, though."
The energy of a roasted pepitas is 44.

Chapter - Pickle

A pickle is a kind of food.
The description is "A seriously crunchy pickle."

Chapter - Pi

A pi is a kind of food.
The description is "The recipe for Pi was described in ancient times by Alphimedes of Salatu, who also purportedly invented a heat ray for attacking the Rook. (If the heat ray ever existed, it has long since been lost.) It was later improved upon by Ludolph the Cerulean, named for his bright blue skin. Ludolph gave a Pi to several of the giants. Tii immediately stated that Pi was irrational. Pot, on the other hand, declared this to be the best pie he’d ever eaten - transcendental, in fact."

[square pi => "Pi aren't square! Pies are round!"]
[eat pi => "You suddenly feel as though you have 3141 digits, and yet, you feel strangely incomplete." ]
[estimate pi => random number, estimate that many digits and grant favor that is the sum of those digits. 
"Estimate pi. You get 3,1,4,1,5,9, and 2 favor with Tii, for a total of 25 favor.
digits: 3, 1, 4, 1, 5, 9, 2, 6, 5, 3, 5, 8, 9, 7, 9, 3]

Chapter - Pineapple

A pineapple fruit is a kind of food. The printed name is "pineapple".
The description is "An exceptionally prickly pineapple."

Chapter - Plain Noodles

A plain noodles is a kind of food.
The description is "Some good, honest, plain noodles."

Chapter - Plum

A plum is a kind of food.
The description is "A plummy plum."

Chapter - Potato Patty

A potato patty is a kind of food.
The description is "One potato, mashed and fried in a pleasing disc shape."
The plural of potato patty is potato patties.

Chapter - Potcorn

A potcorn is a kind of food.
The description is "Pot corn is a regular corn made to pop because its kernels have a hard moisture-sealed hull and a dense starchy interior. This allows pressure to build inside the kernel until an explosive 'pop' results."

Chapter - Potian's Feast

A potians feast is a kind of food. The printed name is "Potian's feast".
The description is "The greatest, most magnificent, energy-filled, Pot-approved combination of nourishment. A fitting dish to make or eat for any serious Potian."
The plural of potian's feast is potians' feasts.

Chapter - Pottine

A pottine is a kind of food.
The description is "So wrong. But so, so right."

Chapter - Precious Potato Salad

A precious potato salad is a kind of food.
The description is "Potato salad, traditionally an affordable staple at Glitchen birthdays, is now fit for fancy dinners and lavish banquets with the addition of the particularly precious Trump Rub."

Chapter - Proper Rice

A proper rice is a kind of food.
The description is "A steaming bowl of slightly sticky rice."

Chapter - Pumpkin Pie

A pumpkin pie is a kind of food.
The description is "When people use the phrase 'as nice as pie', they are, in fact, talking about this pie. What goes into it? Fresh pumpkin, crispy pastry, spicy spices, and a big dollop of love. (That's an attitude rather than a hidden ingredient, before you start feeling nauseous)."

["Who ate all the pie? You did, and it was awesome."
increase player's energy by 120;
increase player's mood by 120.]

Chapter - Red

A red thing is a kind of food. The printed name is "red".
The description is "Some things are so basic, so fundamental that they only need one word to describe what they are. This perfect blend of tomato, onion and butterfly milk sums up the essence of red."

Chapter - Rich Tagine

A rich tagine is a kind of food.
The description is "A steaming pot of zesty, slow-cooked tagine."

Chapter - Roux

A roux is a kind of food.
The description is "Roo!"

Chapter - Salmon Jaella

A salmon jaella is a kind of food.
The description is "An assortment of fresh Salmon from Jal, Rice, Legumes and veggies thrown together into a dish Jal-loving Glitchen identified themselves by."

Chapter - Pocket Salmon

A pocket salmon is a kind of food.
The description is "It's like salmon, but in your pocket! Pocket Salmon! The handy friendly fish-at-your-fingertips that's always ready to go! Why settle for boring old underwater catch-me-if-you-calmon-salmon when you could have the ever-accessible, always-dependable, never-stinky always-yummy Pocket Salmon instead! POCKET SALMON! [bracket]TM. Always read the label. Terms and conditions apply[close bracket]".
The plural of pocket salmon is pocket salmen.

[release salmon]

Chapter - Sammich

A basic sammich is a kind of food. The printed name is "sammich".
The description is "A basic bun 'n' meat sammich."
The plural of sammich is sammiches.

Chapter - Scrumptious Frittata

A scrumptious frittata is a kind of food.
The description is "A truly tantalizing scrumptious frittata."

Chapter - Secret Sauce

A secret sauce is a kind of food.
The description is "An enigmatic jar full of mysteriously yummy secret sauce."

Chapter - Sesame Oil

A sesame oil is a kind of food.
The description is "Some slippery sesame oil."

Chapter - Simple BBQ

A simple bbq is a kind of food.
The description is "Some hot meat with tangy sauce."

Chapter - Simple Slaw

A simple slaw is a kind of food.
The description is "The simplest of slaws."

Chapter - Snack Pack

A snack pack is a kind of food.
The description is "An apple, some cheese, and a couple of pickles. Not quite a meal, but it'll do until dinner."

Chapter - Sno Cones

A sno cone is a kind of food.

A sno cone has a number called img. Img is usually 0.

Book - Blue Sno Cone

A blue sno cone is a sno cone.
The description is "A delicious, refreshing Blue Sno Cone with a tangy hit of iMG. Blended to perfection using ice, hooch, and the very finest elemental additives and preservatives, it tastes exactly what the the concept of blue should taste like. And a little like raspberry, weirdly."

The img of blue sno cone is 19.

Book - Green Sno Cone

A green sno cone is a sno cone.
The description is "A bright green blend of ice, hooch and elements make a drink the color of days when spring is born, or nights when the northern lights perform. Packed with a modest hit of iMG, winter cannot fade it. Mainly because it's 40% elemental additives and preservatives."

The img of green sno cone is 37.

Book - Orange Sno Cone

An orange sno cone is a sno cone.
The description is "A chillingly refreshing bright Orange Sno Cone, with a medium amount of iMG. A perfect blend of Ice, Hooch, and elemental additives and preservatives, it is the epitome of an orange drink. Not orange the fruit, that is, orange the colour. It's more of a concept."

The img of orange sno cone is 75.

Book - Purple Sno Cone

A purple sno cone is a sno cone.
The description is "A refreshing and delicious purple Sno Cone. A sophisticated blend of Ice, Hooch and elemental additives and preservatives. Now you too can get all the social frisson of Purple but with none of the nutritional or mental expansion benefits (contains considerable iMG, though)."

The img of purple sno cone is 275.

Book - Rainbo Sno Cone

A rainbo sno cone is a sno cone.
The description is "A rainbo in Sno Cone form, eating this blend of all the other Sno Cones makes your tongue tingle, your sinuses snigger and your spine spontaneously decide to go on a tropical vacation to Shimmyville. Warning: Contains gloriously high levels of iMG."

The img of rainbo sno cone is 550.

Book - Red Sno Cone

A red sno cone is a sno cone.
The description is "A tongue-tingling spine-shiveringly Red Sno Cone. A seamless blend of Ice, Hooch, and a secret blend of elemental additives, preservatives, iMG and raw energy that make you feel slightly, though not to any copyright-infringing extent, like you may have wings."

The img of red sno cone is 150.

[drop a sno cone => becomes a melted pile of mush that eventually vanishes?]
[pick up => "You can't unscramble an egg. And once you drop a sno cone, you're out of luck."]
[drop => "A dropped sno cone is a painful thing to behold."]
[after eating 3: "Careful! Eating this might freeze your brain, which will cost you all your mood!"]
[eat anyway: 50% chance of "Aiiiiiii! Can't… feel… my brain?!? Brain freeze!"]
[on the 3rd: "This Sno Cone almost gave you a Brain Freeze! I would consider carefully before eating another one."]

Chapter - Spicy Quesadilla

A spicy quesadilla is a kind of food.
The description is "An ooey-gooey spicy quesadilla."

Chapter - Spinach Salad

A spinach salad is a kind of food.
The description is "A suspiciously nutritious spinach salad."

Chapter - Stock Sauce

A stock sauce is a kind of food.
The description is "As plain and every day as a woman laughing while eating salad, no one even things about Stock Sauce any more. Perhaps they should."

Chapter - Strawberry

A strawberry is a kind of food.
The description is "A luscious red strawberry."
The plural of strawberry is strawberries.

Chapter - Super Veggie Kebab

A super veggie kebab is a kind of food.
The description is "Chunks of assorted vegetables on a fun pointy stick!"

Chapter - Swank Zucchini Loaf

A swank zucchini loaf is a kind of food.
The description is "A good loaf can be made out of anything. A great loaf is made from Zucchini and talks about how rich it is."
The plural of swank zucchini loaf is swank zucchini loaves.

Chapter - Sweet 'n' Sour Sauce

A sweetened sour sauce is a kind of food.
The description is "Is it sweet? Is it sour? It's both! It's sweetened sour sauce!"

Chapter - Swing Batter

A swing batter is a kind of food.
The description is "After roughly chopping with a knife, this batter is not mixed, blended or whisked, but swung at the end of the arm. Swing batter, batter batter swing, batter (as they say)."

Chapter - Tangy Noodles

A tangy noodles is a kind of food.
The description is "A generous serving of zesty, lemony tangy noodles."

Chapter - Tangy Sauce

A tangy sauce is a kind of food.
The description is "A large jar of gloppy tangy sauce."

Chapter - Tasty Pasta

A tasty pasta is a kind of food.
The description is "A bowl of extra-long noodles with rich bolognese sauce."

Chapter - Tortilla

A tortilla is a kind of food.
The description is "A roundish tortilla."

Chapter - Trump Rub

A trump rub is a kind of food.
The description is "So called because it trumps all the other rubs in expense, flavour, and the ability to be extremely annoying (if you get it in your eye)."
The energy of trump rub is 0. [0.1]

Chapter - Urfu

An urfu is a kind of food.
The description is "A moist beige flaccid matter, imbued with the ability to suck up other flavours."

Chapter - Vegmageddon

A vegmageddon is a kind of food.
The description is "No rich urth-born root or brave brassica can survive the searing heat of a Pugilist Grill. It is a slow, vicious end for them. But justified, they say, in the name of 'Healthy Living'."

Chapter - Waffle

A waffle is a kind of food.
The description is "Fluffy waffles with extra-deep waffle-holes."

Chapter - Wavy Gravy

A wavy gravy is a kind of food.
The description is "One pint of wavy gravy. It's so good, you'll eat it with a spoon."
The plural of wavy gravy is wavy gravies.

Chapter - Whortleberry Jelly

A whortleberry jelly is a kind of food.
The description is "One jar of homemade whortleberry jelly, made from the pulverized remains of a thousand quivering whortleberries."
The plural of whortleberry jelly is whortleberry jellies.

Chapter - Whortleberry

A whortleberry fruit is a kind of food. The printed name is "whortleberry".
The description is "A single delectable whortleberry."
The plural of whortleberry is whortleberries.

Chapter - Wicked Bolognese Sauce

A wicked bolognese sauce is a kind of food.
The description is "A small jar of wicked bolognese sauce, on spaghetti or on its own for a meaty treat."

Chapter - Yummy Gruel

A yummy gruel is a kind of food.
The description is "Somewhat-fizzy-but-still-yummy gruel."

[unused buff: chocolate high; lasts 6 minutes; +90 mood, +60 energy; followed by a sugar crash.]

Chapter - Base Costs

The base_cost of Abbasid Ribs is 201.
The base_cost of Apple is 5.
The base_cost of Applejack is 25.
The base_cost of Awesome Stew is 268.
The base_cost of Banana No-Names is 40.
The base_cost of Banana is 10.
The base_cost of Basic Omelet is 46.
The base_cost of Berry Bowl is 46.
The base_cost of Best Bean Dip is 54.
The base_cost of Big Salad is 58.
The base_cost of Birch Candy is 13.
The base_cost of Birch Syrup is 4.
The base_cost of Blue Sno Cone is 75.
The base_cost of Bubbling Squeak is 60.
The base_cost of Bun is 9.
The base_cost of Bunch of Grapes is 4.
The base_cost of Butter is 10.
The base_cost of Cheese Plate is 58.
The base_cost of Basic Cheese is 15.
The base_cost of Cheezy Sammich is 37.
The base_cost of Cheezy Sauce is 59.
The base_cost of Chilly-Busting Chili is 349.
The base_cost of Choice Crudites is 42.
The base_cost of Cloudberry Jam is 39.
The base_cost of Tart Cloudberry is 2.
The base_cost of Cold Taco is 69.
The base_cost of Common Crudites is 33.
The base_cost of Corn-off-the-Cob is 55.
The base_cost of Corny Fritter is 39.
The base_cost of Creamy Catsup is 81.
The base_cost of Death to Veg is 39.
The base_cost of Deluxe Sammich is 86.
The base_cost of Desssert Rub is 78.
The base_cost of Divine Crepe is 279.
The base_cost of Eggy Scramble is 32.
The base_cost of Exotic Fruit Salad is 33.
The base_cost of Expensive Grilled Cheese is 220.
The base_cost of Flour is 7.
The base_cost of Flummery is 229.
The base_cost of Fortifying Gruel is 271.
The base_cost of Fried Egg is 11.
The base_cost of Fried Noodles is 35.
The base_cost of Fried Rice is 114.
The base_cost of Frog-in-a-Hole is 44.
The base_cost of Nice Fruit Salad is 29.
The base_cost of Gammas Pancake is 57.
The base_cost of Glitchepoix is 45.
The base_cost of Greasy Frybread is 53.
The base_cost of Green Egg is 12.
The base_cost of Green Sno Cone is 150.
The base_cost of Green Thing is 48.
The base_cost of Comforting Grilled Cheese is 90.
The base_cost of Hash is 57.
The base_cost of Hearty Groddle Sammich is 93.
The base_cost of Hearty Omelet is 120.
The base_cost of Heston Mash is 576.
The base_cost of Hi-Sucrose Corn Syrup Square is 31.
The base_cost of Honey is 4.
The base_cost of Hot in Fizzy Sauce is 48.
The base_cost of Hot Potatoes is 66.
The base_cost of Hototot Rub is 77.
The base_cost of Hungry Nachos is 508.
The base_cost of Ix-Style Braised Meat is 234.
The base_cost of Juicy Carpaccio is 71.
The base_cost of Kind BreakfURst Burrito is 292.
The base_cost of King of Condiments is 20.
The base_cost of Lazy Salad is 38.
The base_cost of Legumes Abbassidienne is 22.
The base_cost of Lemburger is 187.
The base_cost of Lemon is 5.
The base_cost of Lotsa Lox is 34.
The base_cost of Luxury Tortellini is 758.
The base_cost of Maburger Royale is 350.
The base_cost of Mangosteen is 10.
The base_cost of Meat Gumbo is 225.
The base_cost of Meat Tetrazzini is 192.
The base_cost of Messy Fry-Up is 60.
The base_cost of Mexicali Eggs is 78.
The base_cost of Mild Sauce is 26.
The base_cost of Mushroom is 3.
The base_cost of Oats is 8.
The base_cost of Oaty Cake is 32.
The base_cost of Obvious Panini is 132.
The base_cost of Oily Dressing is 3.
The base_cost of Olive Oil is 5.
The base_cost of Onion Ring is 51.
The base_cost of Onion Sauce is 64.
The base_cost of Orange Sno Cone is 300.
The base_cost of Orange is 5.
The base_cost of Pad Tii is 392.
The base_cost of Pi is 314.
The base_cost of Pickle is 21.
The base_cost of Pineapple Upside-Down Pizza is 111.
The base_cost of Pineapple Fruit is 7.
The base_cost of Plum is 3.
The base_cost of Pocket Salmon is 15.
The base_cost of Potato Patty is 33.
The base_cost of Potcorn is 136.
The base_cost of Potians Feast is 1000.
The base_cost of Pottine is 267.
The base_cost of Precious Potato Salad is 860.
The base_cost of Proper Rice is 26.
The base_cost of Pumpkin Pie is 111.
The base_cost of Purple Sno Cone is 1100.
The base_cost of Rainbo Sno Cone is 2200.
The base_cost of Rasher of Bacon is 20.
The base_cost of Raw Bio-Organic Carob-ish Treat is 41.
The base_cost of Red Sno Cone is 600.
The base_cost of Red Thing is 30.
The base_cost of Rich Tagine is 332.
The base_cost of Roasted Pepitas is 5.
The base_cost of Roux is 22.
The base_cost of Salmon Jaella is 241.
The base_cost of Basic Sammich is 29.
The base_cost of Scrumptious Frittata is 78.
The base_cost of Secret Sauce is 47.
The base_cost of Sesame Oil is 4.
The base_cost of Simple BBQ is 116.
The base_cost of Simple Slaw is 27.
The base_cost of Snack Pack is 66.
The base_cost of Spicy Quesadilla is 86.
The base_cost of Spinach Salad is 18.
The base_cost of Stinky Cheese 1 is 21.
The base_cost of Stock Sauce is 34.
The base_cost of Strawberry is 4.
The base_cost of Super Veggie Kebab is 256.
The base_cost of Swank Zucchini Loaf is 441.
The base_cost of Sweetened Sour Sauce is 63.
The base_cost of Swing Batter is 31.
The base_cost of Tangy Noodles is 54.
The base_cost of Tangy Sauce is 154.
The base_cost of Tasty Pasta is 338.
The base_cost of Tortilla is 19.
The base_cost of Trump Rub is 128.
The base_cost of Urfu is 73.
The base_cost of Vegmageddon is 90.
The base_cost of Stinky Cheese 2 is 27.
The base_cost of Stinky Cheese 3 is 33.
The base_cost of Waffle is 185.
The base_cost of Wavy Gravy is 75.
The base_cost of Whortleberry Jelly is 75.
The base_cost of Whortleberry Fruit is 5.
The base_cost of Wicked Bolognese Sauce is 79.
The base_cost of Yummy Gruel is 237.

Volume - Spices

A spice is a kind of thing. A spice is edible.
A spice has a number called base_cost. Base_cost is usually 0.
A spice has a number called energy. Energy is usually 0.

Book - Black Pepper

A black pepper is a kind of spice.
The description is "A mound of extra-sneezy black pepper."

Instead of smelling the black pepper:
say "You launch into a sneezing fit. You were expecting something different?";
increase score by 3;
decrease player's energy by 2.

Book - Camphor

A camphor is a kind of spice.
The description is "A small pile of bitter camphor."

Studying camphor is an action applying to one thing.
Understand "study [camphor]" as studying camphor.
Carry out studying camphor:
say "Camphor is bitter, but knowledge is sweet. Slightly sticky, too.";
decrease player's energy by 2;
decrease player's mood by 2;
increase score by 2.

Book - Cardamom

A cardamom is a kind of spice.
The description is "A generous pinch of zesty cardamom. A little goes a long way."

Watching the cardamom is an action applying to one thing.
Understand "watch [cardamom]" as watching the cardamom.
Carry out watching the cardamom: 
say "You observe the cardamom closely for several minutes. Not surprisingly, it does nothing.";
increase score by 1.

Book - Cinnamon

A cinnamon is a kind of spice.
The description is "About a spoonful of versatile cinnamon."

Pinching the cinnamon is an action applying to one thing.
Understand "pinch [cinnamon]" as pinching the cinnamon.
Carry out pinching the cinnamon: 
say "You've always wondered what recipes mean when they ask for 'a pinch of cinnamon.' Now you know.";
increase score by 1;
decrease player's energy by 3.

Book - Cumin

A cumin is a kind of spice.
The description is "A heap of pleasantly aromatic cumin."

Instead of tasting the cumin:
say "Powdery cumin coats your tongue. It's not unpleasant, but it's not exactly pleasant, either.";
increase score by 2.

Book - Curry

A curry is a kind of spice.
The description is "A top-secret blend of curry powder."
The plural of curry is curries.

Scrutinizing the curry is an action applying to one thing.
Understand "scrutinize [curry]" as scrutinizing the curry.
Carry out scrutinizing the curry: 
say "Yep, that's curry all right.";
decrease player's energy by 1;
increase player's mood by 1.

Book - Garlic

A garlic is a kind of spice.
The description is "A nice stinky garlic."

After eating garlic:
say "Your breath is icky."

[After one minute: say "The power of garlic lives on in your mouth.";

[After 5 minutes: 
say "You no longer have the taste of garlic in your mouth.";
increase player's mood by 15. ]

Book - Ginger

A ginger is a kind of spice.
The description is "A nubbin of pungent ginger."

Instead of smelling the ginger:
say "Ah, sweetly aromatic ginger. Tickly to the nose, soothing to the senses.";
increase score by 1;
decrease player's energy by 3;
increase player's mood by 2.

Book - Hot Pepper

A hot pepper is a kind of spice.
The description is "A scoop of potentially combustible hot pepper."

Blowing on the pepper is an action applying to one thing.
Understand "blow on [hot pepper]" as blowing on the pepper.
Carry out blowing on the pepper: 
say "A cloud of hot pepper rises in the air. Your eyes! Your eyes!";
decrease player's mood by 5.

Book - Licorice

A licorice is a kind of spice.
The description is "A nub of chewy licorice."

Instead of eating licorice (called L):
say "So... very... chewy. You're going to be picking licorice out of your teeth for days.";
decrease player's energy by 3; 
increase player's mood by 5;
[remove L from play.]

Flattering the licorice is an action applying to one thing.
Understand "flatter [licorice]" as flattering the licorice.
Carry out flattering the licorice: 
say "The licorice seems stalwartly immune to your charms. Or is it?";
decrease player's energy by 1.

Book - Mustard

A mustard is a kind of spice.
The description is "A dash of tangy mustard."

Plastering the mustard is an action applying to one thing.
Understand "plaster [mustard]" as plastering the mustard.
Carry out plastering the mustard: 
say "Ah, a good old-fashioned mustard plaster. It's good for what ails you.";
decrease player's mood by 4;
increase player's energy by 10.

Book - Nutmeg

A nutmeg is a kind of spice.
The description is "A sweet-smelling nutmeg seed."

Instead of rubbing or touching the nutmeg: 
say "You polish the nutmeg to a shiny gloss. This is strangely rewarding.";
increase player's mood by 3;
decrease player's energy by 5.

Book - Old(er) Spice

An older_spice is a kind of spice. The printed name is "old(er) spice". Understand "older spice" and "old(er) spice" as older_spice.
The description is "A handful of colorful older spice."

Gazing at the spice is an action applying to one thing.
Understand "gaze at [older_spice]" as gazing at the spice.
Carry out gazing at the spice: 
say "This colorful handful of old(er) spice almost reminds you of something. Now if only you could remember what it is.";
decrease player's energy by 5.

[Remembering: After 5 minutes: "Oh, now you remember what old(er) spice reminds you of." increase player's mood by 5.]

Book - Pinch of Salt

A pinch of salt is a kind of spice.
The description is "A tiny pinch of very salty salt."
The plural of pinch of salt is pinches of salt.

Book - Saffron

A saffron is a kind of spice.
The description is "Some tendrils of bitter saffron."

Loving the saffron is an action applying to one thing.
Understand "love [saffron]" as loving the saffron.
Carry out loving the saffron: 
say "Awww. The saffron loves you back.";
decrease player's energy by 2;
increase player's mood by 2.

Book - Turmeric

A turmeric is a kind of spice.
The description is "Some uncommonly orange turmeric."

Instead of touching the turmeric:
say "Feels real turmericky, for sure.";
increase score by 10;
decrease player's energy by 2;
increase player's mood by 2.

Book - Base Cost

The base_cost of Black Pepper is 4.
The base_cost of Camphor is 20.
The base_cost of Cardamom is 12.
The base_cost of Cinnamon is 8.
The base_cost of Cumin is 8.
The base_cost of Curry is 5.
The base_cost of Garlic is 4.
The base_cost of Ginger is 4.
The base_cost of Hot Pepper is 4.
The base_cost of Licorice is 8.
The base_cost of Mustard is 4.
The base_cost of Nutmeg is 12.
The base_cost of Older_Spice is 20.
The base_cost of Pinch of Salt is 2.
The base_cost of Saffron is 12.
The base_cost of Turmeric is 12.

Volume - Drink

A drink is a kind of thing.

A drink has a number called mood. Mood is usually 0.
A drink has a number called energy. Energy is usually 0.
A drink has a number called base_cost. Base_cost is usually 0.

Chapter - Beer

A beer is a kind of drink.
The description is "A shiny can of mmm... beer."
The mood of beer is 3.

After drinking beer:
buzzed wears off in 5 turns from now; [5 minutes?]
say "That is a nice buzz you got going on."

At the time when buzzed wears off:
decrease the player's energy by -35;
increase the player's mood by 15;
say "You feel your buzz fading."

Chapter - Bubble Tea

A bubble tea is a kind of drink.
The description is "A super-frothy bubble tea."
The mood of bubble tea is 30.
The energy of bubble tea is 10.

[Bubble-Enhanced Mediation is a buff acquired from drinking Bubble Tea that gives double rewards for meditating. The buff lasts for a total of 2 minutes.]

Chapter - Butterfly Milk

A butterfly milk is a kind of drink.
The description is "A vial of butterfly milk. It has the tingly effervescence of a thousand tiny butterfly farts."
The mood of butterfly milk is 6.

Shaking is an action applying to one thing.
Understand "shake" as shaking.
Carry out shaking: say "You shake it to the right. You shake it to the left. Nothing happens."

Instead of shaking a butterfly milk (called B):
say "You shake the butterfly milk vigorously. Butterfly butter!";
decrease player's energy by 2;
[remove the C from play;]
[now the player carries a random butterfly butter that is off-stage.]

[sniffing butterfly milk is advised for curing the blues]
Instead of smelling a butterfly milk:
say "Butterfly milk smells like perfume from France. You experience a momentary surge of elation.";
increase player's mood by 12.
[Only works when mood is low. "You tried to sniff a Butterfly Milk. Sniffing Butterfly Milk only works when you're feeling down."]

Chapter - Carrot Margarita

A carrot margarita is a kind of drink.
The description is "A thick, warm carrot margarita."
The mood of carrot margarita is 38.
The energy of carrot margarita is 36.

After drinking a carrot margarita:
say "Zing!"

Chapter - Cloud 11 Smoothie

A cloud 11 smoothie is a kind of drink.
The description is "A Cloud 11 smoothie. Pretty much the best smoothie ever invented in the history of smoothies."
The mood of cloud 11 smoothie is 45.

Chapter - Cloudberry Daiquiri

A cloudberry daiquiri is a kind of drink.
The description is "A nourishing cloudberry daiquiri. It goes down smooth."
The mood of cloudberry daiquiri is 60.
The energy of cloudberry daiquiri is 10.

Chapter - Coffee

A coffee is a kind of drink.
The description is "A steaming mug of strong, life-affirming coffee."
The mood of coffee is 12.

Chapter - Cosma-politan

A cosma-politan is a kind of drink.
The description is "An urbane, sophistimicated cosma-politan."
The mood of cosma-politan is 80.
The energy of cosma-politan is 5.

Chapter - Creamy Martini

A creamy martini is a kind of drink.
The description is "A shaken-and-stirred-and-shaken-again creamy martini."
The mood of creamy martini is 25.
The energy of creamy martini is 10.

Chapter - Urthshaker

An urthshaker is a kind of drink.
The description is "A seismically upgraded urthshaker."
The mood of urthshaker is 10.
The energy of urthshaker is 30.

[Impervious Miner: mining uses no energy at all for 3 minutes]

Chapter - Exotic Juice

An exotic juice is a kind of drink.
The description is "A goblet of mysteriously yummy exotic juice."
The mood of exotic juice is 20.
The energy of exotic juice is 10.

[Pleasant equilibrium: being in a really bad mood does not deduct from iMG earned for 5 minutes]

Chapter - Flaming Humbaba

A flaming gumbaba is a drink. The printed name is "Flaming Humbaba." Understand "flaming humbaba" and "humbaba" as flaming gumbaba.
The description is "A 5-alarm flaming Humbaba.".
The mood of flaming gumbaba is 5. 
The energy of flaming gumbaba is 20.

[Flaming grinder: Refine any ore without using energy for 30 seconds]

Chapter - Fruity Juice

A fruity juice is a kind of drink.
The description is "A glass of nigh-ambrosial fruit juice."
The mood of fruity juice is 20.

Chapter - Gurly Drink

A gurly drink is a kind of drink.
The description is "A sweet, innocent gurly drink."
The mood of gurly drink is 30.
The energy of gurly drink is 5.

[Easy Animalia: all interactions with domestic animals (except singing or whistling) do not cost energy. lasts 5 minutes]

Chapter - Hooch

A hooch is a kind of drink.
The description is "One jug of premium high-octane hooch."
The plural of hooch is hooches.
The mood of hooch is 5.

[After drinking hooch: "You feel completely smashed." +12 mood, -12 energy]
[Smashed lasts 4 minutes; say "You don't feel as smashed anymore."; Hungover begins.]
[one turn later: "Your head really hurts from your hangover".  -10 mood]
[Hungover lasts 5 minutes; say "That hangover is gone! You feel so much better."; +10 mood, +10 energy]

Chapter - Lemon Juice

A lemon juice is a kind of drink.
The description is "A tall glass of exquisitely sour lemon juice."
The mood of lemon juice is -5.
The energy of lemon juice is 10.

Chapter - Mabbish Coffee

A mabbish coffee is a kind of drink.
The description is "A Mabbish coffee has all the goodness of regular coffee, but gooder."
The mood of mabbish coffee is 20.
The energy of mabbish coffee is 5.

Chapter - Mega Healthy Veggie Juice

A mega healthy veggie juice is a kind of drink.
The description is "A bracing tumbler of mega-healthy veggie juice."
The mood of mega healthy veggie juice is 10.
The energy of mega healthy veggie juice is 20.

Chapter - Orange Juice

An orange juice is a kind of drink.
The description is "A surprising glass of orange juice."
The mood of orange juice is 20.
The energy of orange juice is 15.

Chapter - Pumpkin Ale

A pumpkin ale is a kind of drink.
The description is "All the refreshment of beer combined with the autumnal savoury heft of pumpkin. Then combined with cinnamon. For no reason anyone can decipher."
The mood of pumpkin ale is 50.

Chapter - Pungent Sunrise

A pungent sunrise is a kind of drink.
The description is "A refreshingly pungent sunrise."
The energy of pungent sunrise is 20.

Chapter - Savory Smoothie

A savory smoothie is a kind of drink.
The description is "A savory smoothie. It sticks to your ribs and doesn't let go."
The mood of savory smoothie is 10 [+ 5/100 of new mood].

Chapter - Slow Gin Fizz

A slow gin fizz is a kind of drink.
The description is "A low and lazy slow gin fizz."
The plural of slow gin fizz is slow gin fizzes.
The mood of slow gin fizz is 60.
The energy of slow gin fizz is 10.

Chapter - Spicy Grog

A spicy grog is a kind of drink.
The description is "A tall glass of exceedingly spicy grog."
The mood of spicy grog is 30.
The energy of spicy grog is 5.

Chapter - Too-Berry Shake

A too-berry shake is a kind of drink.
The description is "A berry tasty too-berry shake."
The mood of too-berry shake is 5.
The energy of too-berry shake is 30.

Chapter - Wine of the Dead

A wine of the dead is a kind of drink.
The description is "A forbidding decanter filled with wine of the dead, made from grapes crushed in Purgatory. This Hade-licious drink will revive even the most pooped of hellions... but will kill all who drink it aboveground."
The plural of wine of the dead is wines of the dead.

Before drinking wine of the dead:
say "Bottoms up! What's the worst that can happen?".
[now the player is not pooped; or dead if drunk while alive]

Chapter - Base Costs

The base_cost of Beer is 10.
The base_cost of Bubble Tea is 172.
The base_cost of Carrot Margarita is 90.
The base_cost of Cloud 11 Smoothie is 69.
The base_cost of Cloudberry Daiquiri is 142.
The base_cost of Coffee is 5.
The base_cost of Cosma-politan is 131.
The base_cost of Creamy Martini is 60.
The base_cost of Cup of Water is 1.
The base_cost of Urthshaker is 152.
The base_cost of Exotic Juice is 54.
The base_cost of Face Smelter is 141.
The base_cost of Flaming_Humbaba is 168.
The base_cost of Fruity Juice is 24.
The base_cost of Gurly Drink is 160.
The base_cost of Hooch is 15.
The base_cost of Lemon Juice is 39.
The base_cost of Mabbish Coffee is 54.
The base_cost of Mega Healthy Veggie Juice is 46.
The base_cost of Orange Juice is 39.
The base_cost of Pumpkin Ale is 83.
The base_cost of Pungent Sunrise is 197.
The base_cost of Savory Smoothie is 96.
The base_cost of Slow Gin Fizz is 76.
The base_cost of Spicy Grog is 51.
The base_cost of Too-Berry Shake is 76.
The base_cost of Wine of the Dead is 66.

Consumables ends here.
